---
id: "1825"
title: "Metabeskrivelse"
description: "En metabeskrivelse er en kort beskrivelse af et websted eller en bestemt side på et websted. Den bruges typisk af søgemaskinerne til at vise et resumé af webstedet eller siden i deres søgeresultater."
header: "Generer en kort beskrivelse af dit websted eller en bestemt side på dit websted."
placeholder: "genanvendelig kop, miljøvenlig"
usage: "Metabeskrivelser bruges ofte i SEO til at hjælpe websteder og sider med at få en højere placering i søgemaskineresultaterne. Følgende generator kan hjælpe dig med at oprette metabeskrivelser, der er skræddersyet til dine specifikke søgeord og passer bedst til dit brand."
help_hint: "Hvad handler dit websted eller din side om? Skriv det ned, så laver vi det om til en metabeskrivelse."
tags: ["Copywriting"]
date: "2022-04-10"
slug: "/da/tools/blog/meta-descriptions"
lang: "da"
icon: "metaDescription"
hasCustomTemplate: false
tone: false
templateKey: 'tools-body'
product_type: "31"
url: "/app/meta-descriptions"
---

# AI-Powered Meta Description Generator Tool

## Introduction

The AI-powered meta description generator tool is a cutting-edge solution for creating optimized meta descriptions for your website. Designed to run on an AI-powered copywriting platform, this tool leverages the power of artificial intelligence to generate high-quality and engaging descriptions that will help improve your website's SEO ranking.

## Key Features

- AI-powered technology: Our tool uses advanced algorithms and machine learning techniques to generate optimized meta descriptions that are both effective and engaging.
- Customizable settings: You can adjust the tool's settings to tailor the output to your specific needs, including keywords, tone, and length.
- User-friendly interface: The interface is intuitive and easy to use, making it simple for anyone to create compelling meta descriptions for their website.
- Real-time feedback: The tool provides real-time feedback on your descriptions, including suggestions for improvement and warnings about common mistakes.

## Benefits

- Improved SEO ranking: By using optimized meta descriptions, your website is more likely to rank higher in search engine results, resulting in increased traffic and visibility.
- Time-saving: Generating high-quality meta descriptions can be a time-consuming process, but with our tool, you can create multiple descriptions in a matter of minutes.
- Professional-quality output: Our tool produces descriptions that are professional, engaging, and optimized for search engines, ensuring that your website makes a strong impression on potential visitors.
- Increased engagement: Well-written meta descriptions can help attract more visitors to your website, leading to increased engagement and conversions.

## Conclusion

The AI-powered meta description generator tool is a powerful solution for anyone looking to improve their website's SEO ranking and increase engagement. With its user-friendly interface, customizable settings, and real-time feedback, it's the perfect tool for anyone looking to take their website to the next level. Try it today and see the difference for yourself!
